2222222222
2220000222
2220000022
2203003022
2000000002
0000000002
1100003022
1111000222
1311102222
1111111122
